Width: 30 Height: 20 Background: 1
3  2  2  3  3  2  2  11 11 11 11 11 11 3  2  2  3  3  3  3  2  2  3  11 11 11 11 11 2  2 
2  2  11 2  2  2  3  3  11 11 11 11 11 11 2  2  11 11 2  2  2  11 11 11 11 11 11 11 11 3 
2  16 3  3  3  2  11 11 11 11 11 11 11 11 11 11 11 11 11 2  2  11 11 11 11 11 11 11 11 11
2  3  2  2  3  3  3  17 11 11 11 11 11 2  2  11 11 11 11 3  11 11 11 11 8  12 11 11 11 3 
2  2  3  2  3  2  2  11 11 11 11 11 11 11 3  2  11 11 11 11 11 11 11 8  12 8  11 2  3  11
3  2  2  11 2  2  11 11 11 11 11 11 11 11 11 11 3  11 11 11 11 11 11 11 8  11 11 11 2  3 
3  2  2  2  2  11 11 11 11 11 11 11 11 11 2  8  2  2  11 11 11 11 2  11 11 11 11 11 2  3 
0  2  3  11 0  0  11 11 11 11 11 4  4  4  4  15 4  4  4  4  4  2  3  11 11 11 11 11 11 2 
3  3  2  2  0  0  0  0  11 11 11 4  4  2  4  2  0  2  3  2  4  11 11 11 11 2  11 11 11 11
2  11 2  0  0  0  0  3  2  11 11 4  2  4  3  2  2  3  4  2  4  11 11 11 11 11 11 11 11 11
2  0  0  0  0  0  2  11 2  2  8  4  4  3  0  4  3  12 0  2  15 8  11 3  11 0  0  11 11 11
15 0  11 0  7  2  2  2  2  2  7  4  2  4  2  3  2  2  2  19 4  2  2  2  0  0  0  0  2  11
5  0  0  11 5  2  2  2  11 2  2  4  0  4  0  7  3  2  19 19 2  3  2  12 8  2  2  2  3  3
5  11 11 0  5  3  2  11 3  3  2  4  4  2  3  0  4  2  4  19 4  2  2  0  0  3  3  2  2  11
5  11 11 0  5  11 11 2  0  2  2  4  2  0  0  4  0  3  2  19 4  2  11 11 0  0  2  11 2  2 
5  11 0  0  5  11 3  2  3  0  2  4  0  4  3  19 2  4  19 4  4  11 11 11 11 11 2  2  3  3 
8  0  0  11 5  8  3  11 12 2  7  4  4  3  2  4  19 3  19 2  4  11 11 11 8  2  3  3  13 0
0  11 0  0  0  2  3  2  2  3  2  4  2  19 2  19 2  3  4  2  4  2  11 11 17 11 2  0  0  0
2  0  0  0  11 11 2  3  11 0  3  4  3  4  3  2  3  4  4  19 4  3  3  11 11 11 11 11 0  11
2  3  1  0  2  3  11 2  11 2  0  4  19 2  3  4  19 4  19 4  4  11 2  11 3  2  11 11 11 11
playerRotation: 3
playerHasRifle: 0
playerStartAmmo: 0
mirrorRotations: 0 2 0 2
lancerRotations: 1 2 0
lancerCoolDowns: 4 4 4
togglerStates: 1
togglerCoolDowns: X
ammoSupplies: X