Width: 32 Height: 24 Background: 1
0  2  3  3  2  2  3  11 2  2  0  11 0  3  3  2  2  4  4  4  4  4  4  4  4  4  4  4  4  4  4  4  
2  0  3  11 2  0  11 2  3  19 2  0  3  0  2  2  2  4  4  4  4  4  4  4  4  4  4  4  4  4  4  4  
0  2  0  11 0  0  0  19 19 19 19 3  3  0  11 3  3  4  4  2  2  0  15 2  2  2  2  3  3  0  11 0  
11 0  0  0  0  11 0  2  19 19 0  0  0  11 11 3  3  4  4  3  11 11 8  2  3  2  2  3  3  11 13 0  
1  0  11 11 3  0  0  0  2  11 11 2  11 11 11 19 2  4  4  11 11 11 11 11 11 11 2  3  3  11 0  11 
0  0  11 11 11 0  0  0  11 11 0  11 11 11 11 19 19 4  4  11 11 11 11 11 11 11 2  3  3  3  3  3  
11 11 11 11 0  11 0  2  11 11 3  11 11 11 11 19 19 4  4  2  11 11 2  11 11 11 2  2  3  3  3  3  
2  0  2  11 0  0  0  0  3  3  3  0  11 11 11 11 19 4  4  11 11 11 11 2  11 11 3  2  2  2  2  2  
0  3  2  3  3  0  11 3  3  2  3  0  3  0  3  3  11 4  4  11 11 11 11 11 11 11 11 2  2  3  3  3  
3  3  0  3  2  11 0  0  3  3  11 0  0  0  2  19 3  4  4  11 11 11 11 11 11 11 11 11 11 11 3  11 
11 0  0  0  2  2  11 2  2  2  0  11 0  11 0  3  3  4  4  2  11 11 11 11 11 11 11 11 11 11 11 2  
11 2  2  0  12 2  11 2  11 11 0  2  0  0  0  0  3  4  4  11 2  11 11 11 11 11 11 11 2  2  11 2  
2  11 0  0  8  11 11 2  11 2  11 3  2  11 11 2  0  4  4  4  4  4  11 0  11 4  4  4  4  4  0  4  
0  11 3  0  11 3  3  2  2  3  3  0  11 11 11 11 11 4  4  4  4  4  0  0  0  11 0  4  4  4  11 11 
11 2  11 11 11 3  3  3  3  11 11 11 11 11 11 11 11 11 2  2  3  11 2  11 11 11 11 0  11 11 0  3  
3  3  11 0  2  3  0  3  11 11 11 11 11 11 11 11 11 11 11 11 2  3  3  11 11 11 0  3  3  3  2  2  
19 3  11 2  19 11 0  11 11 11 11 11 11 11 11 11 11 11 11 11 2  3  2  2  3  0  0  11 3  3  19 2  
11 11 11 3  11 0  0  2  11 11 11 11 11 11 11 11 11 11 11 3  19 19 19 2  11 11 0  0  11 19 11 3  
3  11 11 0  0  2  2  11 11 11 11 11 11 11 11 11 11 11 11 3  2  19 3  11 0  0  0  11 0  11 3  2  
2  11 3  2  19 3  11 11 11 11 11 11 11 11 11 11 11 11 11 0  0  3  11 2  11 0  11 11 0  2  2  3  
0  11 2  19 3  11 3  11 11 11 11 11 11 11 11 11 11 11 11 3  11 2  11 11 11 11 0  11 11 11 19 2  
0  0  11 2  0  11 11 11 11 11 11 11 11 11 11 11 11 11 11 11 11 11 11 11 2  3  0  2  11 2  19 3  
3  2  0  11 11 3  2  11 11 11 11 11 11 11 11 11 11 11 11 11 11 2  11 11 11 11 11 3  2  19 19 2  
11 11 11 3  11 11 19 2  3  11 11 11 11 2  2  11 11 11 3  2  3  11 3  2  3  3  3  2  3  2  19 19 
playerRotation: 0
playerHasRifle: 0
playerStartAmmo: 0
mirrorRotations: X
lancerRotations: 0 
lancerCoolDowns: 9999 
togglerStates: X
togglerCoolDowns: X
ammoSupplies: X
