Width: 20 Height: 20 Background: 1
4  4  19 4  2  4  11 4  4  4  4  4  4  4  4  4  4  4  4  4
4  4  19 19 3  2  4  4  4  5  5  5  5  5  5  5  3  3  3  3
11 2  3  19 19 4  11 4  4  6  4  11 11 11 11 4  11 3  2  3
4  19 3  4  3  4  4  4  4  2  4  11 11 11 11 11 11 2  3  3
4  3  11 3  11 11 4  11 4  2  4  11 11 4  11 11 11 2  3  2
4  11 2  11 11 11 11 11 4  3  4  11 10 13 11 11 11 11 3  2
4  0  11 11 11 11 11 11 4  2  4  11 11 11 11 11 11 11 3  2
4  0  0  11 11 11 11 11 11 11 11 11 11 11 11 4  11 3  3  3
4  0  0  4  4  4  4  4  4  4  4  4  4  11 11 4  4  3  3  3
4  0  11 4  4  4  4  4  3  4  4  4  4  4  11 4  4  3  3  3
4  11 0  4  4  4  4  4  4  4  3  4  4  4  4  4  4  3  2  3
4  0  0  0  4  4  4  3  4  4  4  4  4  4  4  4  2  3  3  3
4  0  0  3  2  4  4  4  4  4  4  4  4  2  3  3  3  3  2  2
4  0  0  3  2  2  2  7  5  5  5  5  3  3  3  2  3  2  3  2
4  11 2  2  2  4  4  3  4  2  4  4  3  3  2  2  2  11 2  2
4  0  0  2  2  4  4  12 4  12 4  4  3  2  11 2  2  2  2  3
4  2  0  11 3  4  4  2  4  3  4  4  2  2  2  2  2  0  11 0
4  0  11 3  2  4  4  12 4  12 4  4  3  2  11 3  2  11 2  0
4  3  1  3  3  4  4  3  4  3  3  4  11 11 2  3  11 2  11 11
4  11 0  11 3  4  4  2  4  3  4  4  2  11 11 0  3  11 11 2
playerRotation: 3
playerHasRifle: 1
playerStartAmmo: 3
mirrorRotations: 0
lancerRotations: X
lancerCoolDowns: X
togglerStates: X
togglerCoolDowns: X
ammoSupplies: 4