Width: 20 Height: 34 Background: 2
3  2  2  11 3  2  2  3  3  2  2  2  2  2  3  3  13 2  2  2
2  13 3  2  0  12 11 2  11 3  3  2  11 2  2  3  2  12 11 0
0  2  3  0  2  2  2  3  3  11 11 2  2  3  2  2  3  2  3  2
11 2  2  2  11 2  2  2  11 11 3  2  2  2  2  3  2  2  3  11
11 2  2  3  3  2  2  3  3  2  2  2  3  2  2  3  0  2  0  2
2  3  2  12 3  3  0  3  2  2  2  2  3  2  3  2  2  2  2  0
2  3  11 2  3  2  2  2  2  2  3  2  2  11 2  2  12 3  2  2
2  2  2  2  2  2  11 2  3  3  3  3  2  2  2  12 2  11 2  3
4  4  4  4  4  4  4  4  3  3  3  3  3  4  4  4  4  4  4  4
2  2  2  2  2  2  2  4  3  3  3  3  0  4  2  2  2  2  2  2
2  4  2  4  2  4  2  4  3  3  3  0  3  4  2  4  2  4  2  4
2  2  2  2  2  2  4  4  0  3  0  3  3  4  4  2  2  2  2  2
2  4  2  4  2  4  4  3  3  3  3  0  3  3  4  4  2  4  2  4
2  2  2  2  4  4  10 3  0  3  0  0  0  3  10 4  4  2  2  2
2  4  2  4  4  10 3  0  0  0  0  3  0  0  3  10 4  4  2  4
2  2  2  2  4  10 3  3  0  3  3  0  0  0  3  10 4  2  2  2
2  4  2  4  4  10 3  0  0  3  14 0  3  0  3  10 4  4  2  4
2  2  2  2  4  10 0  0  0  0  3  0  0  3  0  10 4  2  2  2
2  4  2  4  4  10 3  0  0  0  3  3  0  3  3  10 4  4  2  4
2  2  2  2  4  4  10 3  3  0  0  3  3  0  10 4  4  2  2  2
2  4  2  4  2  4  4  3  0  3  0  3  3  3  4  4  2  4  2  4
2  2  2  2  2  2  4  4  3  3  0  0  3  4  4  2  2  2  2  2
2  4  2  4  2  4  2  4  0  0  3  0  0  4  2  4  2  4  2  4
2  2  2  2  2  2  2  4  0  3  3  0  0  4  2  2  2  2  2  2
2  4  2  4  2  4  2  4  0  0  0  0  3  4  2  4  2  4  2  4
2  2  2  2  2  2  2  4  0  0  0  0  3  4  2  2  2  2  2  2
2  4  2  4  2  4  2  4  0  3  3  0  3  4  2  4  2  4  2  4
2  2  2  2  2  2  2  4  0  3  3  0  0  4  2  2  2  2  2  2
2  4  2  4  2  4  2  4  3  3  0  0  0  4  2  4  2  4  2  4
2  2  2  2  2  2  2  4  3  0  0  3  0  4  2  2  2  2  2  2
4  4  4  4  4  4  4  4  0  0  3  3  0  4  4  4  4  4  4  4
2  2  0  11 0  11 0  3  0  0  0  3  0  0  3  3  0  0  3  2
11 2  3  0  0  0  0  0  0  11 0  0  0  0  0  0  11 11 0  2
2  11 11 0  0  3  2  0  11 11 1  3  0  2  0  3  2  2  3  11
playerRotation: 3
playerHasRifle: 0
playerStartAmmo: 0
mirrorRotations: X
lancerRotations: X
lancerCoolDowns: X
togglerStates: X
togglerCoolDowns: X
ammoSupplies: 7 4 3 6 0 9 5 3 2 1 3 1 0 4
1.  Salvager
2.  Wall
3.  Cracked Wall
4.  Hard Wall
5.  Node
6.  Receiver
7.  Mirror
8.  PressurePlate
9.  Plasma Film
10. Ammo
11. Ice Patch
12. Bomb Wall
13. Fuel Cell
14. The Rifle
15. Plasma Lancer
16. Toggler
17. Furnace
18. Detector