Width: 34 Height: 20 Background: 3
11 11 11 2  2  11 2  11 11 11 11 11 11 2  3  11 11 11 11 11 2  4  4  19 19 19 4  19 19 19 19 19 5  19 
2  11 11 11 3  2  2  11 11 3  19 11 11 2  11 11 11 2  11 11 11 4  4  19 6  5  5  2  3  3  3  3  5  5  
2  11 11 11 11 11 11 11 19 3  19 3  11 11 11 11 11 11 11 11 11 4  4  19 19 19 4  0  19 19 19 19 9  19 
11 3  11 11 4  4  4  4  19 19 19 19 11 19 11 11 2  11 11 11 2  4  4  19 18 5  5  2  3  3  3  19 9  19 
11 11 11 11 4  4  4  4  4  19 19 11 11 11 11 2  2  2  8  2  2  4  4  19 19 19 4  0  19 19 3  19 9  19 
11 11 11 11 11 4  4  4  4  4  11 11 11 11 11 2  4  4  15 4  4  4  4  19 18 5  5  2  3  19 3  19 9  19 
11 11 11 2  11 11 4  17 4  4  11 4  11 11 4  2  4  4  2  4  4  4  2  3  19 19 4  0  3  19 3  0  9  19 
2  11 11 2  3  11 11 8  4  4  11 4  11 11 4  11 4  4  2  19 2  3  3  3  19 19 4  0  2  19 2  0  9  19 
11 11 2  11 11 11 11 11 4  4  11 11 11 11 11 11 4  4  7  19 19 19 3  19 7  19 4  0  3  19 3  0  9  19 
11 11 11 11 2  11 2  11 4  4  4  4  4  4  4  4  4  4  2  2  3  19 19 19 19 19 4  0  3  19 3  19 9  19 
3  2  11 11 11 11 11 3  11 4  4  4  4  4  4  4  4  4  4  4  4  4  4  4  4  4  4  0  2  0  3  19 3  19 
2  3  2  2  3  11 11 11 11 11 19 19 19 3  11 11 11 11 11 11 3  3  11 11 11 11 0  0  2  0  2  0  3  19 
2  2  2  2  2  0  2  0  11 11 11 19 19 19 11 11 11 19 11 11 19 19 11 11 4  4  4  4  2  0  9  0  3  19 
3  2  3  2  3  0  0  0  0  11 11 19 11 11 11 11 19 19 11 11 19 11 11 11 4  4  12 5  3  0  3  19 3  19 
3  2  2  2  0  0  0  19 0  0  11 11 11 11 11 3  3  19 2  11 11 11 11 11 4  4  4  4  19 19 3  19 3  19 
3  3  2  0  0  0  19 19 19 0  0  0  4  4  4  4  4  4  4  4  4  4  4  4  4  4  4  4  19 19 2  19 3  19 
2  2  2  0  0  19 19 19 19 0  0  4  11 11 2  2  0  3  3  2  2  2  4  4  4  12 5  5  3  3  2  19 2  19 
2  3  2  0  0  0  19 19 0  0  0  4  2  0  3  2  2  3  11 2  3  3  3  0  4  4  4  4  19 19 19 19 2  19 
2  2  2  2  0  0  0  0  0  0  0  4  13 0  11 11 3  2  3  3  2  3  11 11 4  12 5  5  3  3  2  3  2  19 
3  2  3  3  2  0  0  1  0  0  0  4  11 2  3  11 2  2  3  2  2  11 11 3  4  4  4  4  19 19 19 19 19 19 
playerRotation: 3
playerHasRifle: 1
playerStartAmmo: 5
mirrorRotations: 0 3 
lancerRotations: 1 
lancerCoolDowns: 4 
togglerStates: X
togglerCoolDowns: X
ammoSupplies: X
