Width: 20 Height: 20 Background: 1
4  4  4  4  4  4  4  4  4  4  4  4  3  2  11 11 4  4  4  4  
4  3  4  15 3  2  3  2  2  2  16 17 11 11 11 11 2  3  2  2  
4  4  12 3  3  3  0  2  2  0  4  2  11 13 11 11 2  2  2  2  
4  5  11 3  3  3  3  3  11 2  4  3  11 11 11 11 2  2  3  3  
4  5  5  5  5  5  5  3  11 11 4  2  2  2  11 11 2  12 2  3  
4  3  11 0  2  11 11 2  11 11 7  8  11 11 11 11 15 3  2  2  
4  5  5  5  5  5  5  3  3  11 4  2  11 11 11 11 3  3  3  3  
4  5  0  11 11 2  0  2  0  11 4  3  3  2  2  2  3  2  3  3  
4  5  5  5  5  5  5  5  11 11 4  3  11 3  11 11 2  2  3  2  
4  11 11 0  11 11 0  2  11 11 7  11 11 11 11 8  7  2  3  8  
4  5  5  5  5  5  5  5  3  0  4  2  11 11 11 11 2  2  3  3  
4  5  11 11 0  2  0  11 3  3  4  2  3  0  11 3  2  2  3  3  
4  5  5  5  5  5  5  5  3  11 4  2  11 0  0  0  2  2  3  3  
4  11 11 2  0  2  3  5  2  3  4  3  3  11 0  11 15 3  3  2  
4  5  5  5  5  5  5  5  4  4  4  3  3  0  11 11 11 11 2  2  
2  6  2  2  2  2  2  2  15 8  11 2  0  0  11 11 2  15 2  2  
2  0  11 3  2  19 19 19 19 11 11 11 11 0  0  11 3  8  3  2  
2  11 11 2  11 11 19 19 3  3  11 3  3  0  2  11 11 0  2  19 
2  2  11 0  0  0  11 11 11 11 11 2  2  3  3  0  0  3  2  19 
2  11 2  2  11 1  0  3  2  2  2  2  11 2  11 2  19 19 2  19 
playerRotation: 3
playerHasRifle: 1
playerStartAmmo: 0
mirrorRotations: 3 2 3 
lancerRotations: 0 2 3 2 3 
lancerCoolDowns: 4 4 4 4 4 
togglerStates: 0 
togglerCoolDowns: 0.5 
ammoSupplies: X
