Width: 20 Height: 20 Background: 3
4  11 11 11 11 11 11 16 17 11 11 11 4  4  4  4  4  4  4  4  
4  11 11 4  4  11 11 11 11 11 4  4  4  4  4  4  11 4  4  4  
4  4  11 4  4  12 12 11 4  4  4  4  4  11 11 11 11 4  4  4  
4  11 11 4  11 11 11 11 11 11 11 11 11 11 4  11 11 4  4  4  
4  11 4  4  4  4  4  4  4  11 11 4  11 4  11 11 11 11 11 4  
4  11 11 11 11 11 11 11 11 4  4  11 11 11 11 11 11 11 11 4  
4  4  4  4  4  4  4  11 11 4  4  11 11 4  11 4  11 11 4  4  
19 19 0  0  0  13 4  4  11 11 4  4  4  11 11 11 11 4  4  4  
19 19 19 0  4  4  4  11 11 11 13 12 12 4  11 11 0  0  0  0  
19 19 19 0  11 0  4  11 11 12 12 12 12 4  4  0  0  0  0  1  
19 19 19 19 19 11 11 11 4  12 12 19 12 4  4  4  0  0  2  2  
19 19 19 19 19 19 19 4  4  12 19 19 19 19 4  4  2  2  2  3  
19 19 19 19 19 19 17 4  4  3  3  3  19 4  4  2  3  2  2  3  
19 19 19 19 19 3  3  4  4  2  4  3  2  4  3  2  3  3  2  2  
19 19 19 19 3  3  4  4  4  2  4  2  2  2  2  2  4  2  3  2  
19 19 19 19 3  4  4  3  3  3  4  4  2  2  2  3  2  2  3  3  
19 19 19 3  3  4  3  3  2  2  4  2  3  3  2  2  2  2  3  2  
19 19 19 3  10 4  3  2  2  2  2  2  2  3  3  2  2  2  2  2  
19 19 19 3  4  4  3  2  4  3  2  2  12 2  2  2  2  2  2  3  
19 19 19 3  2  2  3  2  4  3  2  16 2  2  3  2  10 3  2  2  
playerRotation: 2
playerHasRifle: 1
playerStartAmmo: 3
mirrorRotations: X
lancerRotations: X
lancerCoolDowns: X
togglerStates: 0 0 
togglerCoolDowns: 0.5 0.5 
ammoSupplies: 5 3 
