Width: 34 Height: 20 Background: 4
4  11 11 11 11 11 11 3  2  11 11 11 4  4  2  2  2  2  4  19 19 19 19 19 19 19 3  0  4  2  12 2  3  5  
11 11 11 11 11 11 11 11 11 11 11 11 11 10 4  2  4  4  4  19 19 19 19 19 19 0  0  0  4  2  2  3  2  5  
11 11 11 4  4  3  11 11 11 11 3  11 11 11 4  4  4  11 11 11 19 19 19 19 4  4  0  13 4  2  2  2  2  5  
0  11 2  19 19 3  3  3  19 19 2  11 11 11 11 11 11 11 11 11 11 11 11 4  4  4  4  4  4  2  2  2  3  5  
0  0  4  2  19 2  3  2  3  19 19 19 19 11 11 11 11 11 11 11 11 11 11 4  2  3  3  2  2  2  4  2  12 5  
0  0  0  4  4  2  2  2  2  3  19 19 19 19 19 19 4  4  11 11 11 11 11 4  3  2  2  2  2  3  3  2  2  5  
0  0  0  11 11 4  4  4  4  4  19 19 19 19 19 19 2  3  4  11 11 11 11 4  4  4  4  4  7  19 7  5  2  5  
4  0  0  11 11 11 11 11 11 11 19 19 19 19 19 3  3  2  2  4  11 11 11 11 11 4  4  4  3  19 19 8  2  5  
4  4  11 11 11 19 11 11 11 11 11 19 19 3  19 19 19 2  2  4  11 11 11 11 11 11 4  3  19 19 19 3  3  5  
2  4  4  4  19 19 19 11 11 11 11 4  3  3  19 19 19 3  4  4  11 0  0  11 11 11 4  3  15 19 3  2  2  5  
2  2  2  4  4  19 19 11 11 11 11 4  2  2  2  3  19 3  4  0  0  0  0  0  0  11 4  2  5  2  6  12 2  5  
2  3  2  2  4  19 11 11 11 11 11 4  3  2  3  2  3  3  4  0  0  0  0  0  0  0  4  4  5  4  4  4  4  5  
2  2  2  4  4  11 11 11 11 11 11 4  2  2  2  2  2  4  4  0  0  0  0  0  0  0  0  0  18 0  0  6  3  5  
2  2  2  4  3  11 11 11 11 11 4  4  2  2  3  2  2  4  0  0  0  0  0  0  0  4  4  4  4  4  4  2  3  4  
2  2  4  3  3  0  11 11 19 19 4  2  3  2  2  3  3  4  0  0  0  0  0  0  0  4  2  2  2  2  2  3  3  2  
2  4  3  3  3  0  0  19 19 19 4  2  2  2  2  2  3  4  4  0  0  0  0  0  0  4  2  3  2  2  3  3  3  3  
4  4  3  3  0  0  0  3  19 19 4  2  2  3  3  2  2  2  4  4  0  0  0  0  4  4  2  2  2  3  3  3  3  19 
0  0  0  3  0  0  3  3  0  4  4  2  2  2  0  3  2  2  2  4  4  4  6  4  4  2  2  2  2  3  19 19 19 19 
3  0  0  0  0  0  0  0  0  4  2  3  2  2  3  2  3  2  2  2  2  2  15 2  3  3  0  3  2  2  3  19 19 19 
3  3  0  0  1  0  0  0  3  4  2  2  2  3  2  2  2  2  2  3  2  2  2  2  2  2  2  2  3  19 19 19 19 19 
playerRotation: 3
playerHasRifle: 1
playerStartAmmo: 1
mirrorRotations: 0 1 
lancerRotations: 3 0 
lancerCoolDowns: 4 4 
togglerStates: X
togglerCoolDowns: X
ammoSupplies: 5 
