Width: 20 Height: 22 Background: 1
2  2  2  3  3  5  2  2  3  2  3  19 19 19 5  19 19 19 19 19 
3  3  2  2  3  5  2  3  3  3  2  2  3  19 5  19 19 19 19 19 
3  2  2  2  2  5  3  3  2  3  3  3  3  3  5  19 19 19 19 19 
5  5  15 0  0  16 3  2  2  3  2  2  2  2  5  19 19 19 19 19 
2  5  2  2  2  2  2  11 11 11 11 11 2  2  5  19 19 19 19 19 
2  5  3  3  2  2  11 11 11 11 11 11 11 11 17 11 19 19 19 19 
5  5  3  2  2  11 11 11 11 11 11 2  11 11 11 11 19 19 19 19 
3  5  2  2  3  11 11 11 11 19 2  3  19 11 11 11 11 19 19 19 
3  5  3  2  11 11 2  3  19 19 19 19 19 19 19 11 11 11 11 19 
5  16 2  3  11 2  3  3  19 3  11 19 19 19 19 2  11 11 11 3  
2  5  2  11 11 11 3  11 11 11 11 11 3  19 3  2  2  11 11 2  
3  5  2  11 11 11 11 11 8  11 11 8  7  19 3  3  2  2  11 11 
5  5  15 11 11 11 11 11 7  11 11 11 19 19 7  19 3  11 0  0  
3  2  11 11 11 11 11 11 11 11 11 11 3  19 19 19 19 0  13 0  
2  2  11 11 11 11 11 11 11 11 11 2  2  3  19 3  19 19 3  0  
3  2  0  11 17 11 11 11 11 11 2  2  2  2  16 2  2  19 19 19 
5  5  0  0  5  5  5  5  5  5  5  5  5  5  5  5  5  5  5  5  
3  0  0  0  0  3  2  11 11 2  3  2  3  19 3  19 5  19 3  3  
3  2  3  0  0  0  2  11 11 11 2  2  3  19 19 19 19 19 3  19 
2  2  2  2  0  0  0  0  11 11 11 3  19 19 19 19 5  19 19 19 
2  3  2  3  2  0  0  0  0  0  19 19 19 19 19 19 5  19 19 19 
3  2  2  3  2  0  1  0  0  19 19 19 19 3  19 19 19 19 19 19 
playerRotation: 3
playerHasRifle: 0
playerStartAmmo: 0
mirrorRotations: 0 1 1 
lancerRotations: 0 0 
lancerCoolDowns: 5 4 
togglerStates: 0 1 0 
togglerCoolDowns: 0.5 1 0.5 
ammoSupplies: X
