Width: 20 Height: 12 Background: 3
4  4  4  4  4  4  4  4  4  4  4  4  4  4  4  4  4  4  4  4
4  6  5  5  5  5  5  5  5  5  4  4  4  4  4  4  4  4  4  4
4  0  4  4  4  4  4  4  4  7  0  0  3  3  3  3  0  0  6  4
4  3  4  3  3  3  3  10 4  0  0  3  2  2  3  2  3  0  3  4
4  2  4  2  2  2  2  4  4  0  3  0  3  2  0  2  3  3  3  4
4  2  4  2  2  2  2  2  4  3  3  3  3  2  2  3  3  0  3  4
4  0  4  2  2  2  2  2  8  7  3  3  3  3  2  2  2  3  3  4
4  2  4  0  2  2  4  4  4  4  4  4  4  4  4  4  4  4  5  4
4  3  4  0  0  0  0  0  10 2  3  2  3  3  3  3  3  3  5  4
4  0  4  4  4  0  0  0  4  3  3  3  2  3  3  3  0  3  5  4
4  7  2  2  8  0  0  0  4  3  12 3  3  2  0  2  13 0  5  4
2  4  4  4  4  4  1  0  4  3  3  4  4  4  4  4  0  0  5  4
playerRotation: 3
playerHasRifle: 1
playerStartAmmo: 0
mirrorRotations: 2 2 0
lancerRotations: X
lancerCoolDowns: X
togglerStates: X
togglerCoolDowns: X
ammoSupplies: 9 1