Width: 20 Height: 20 Background: 1
2  2  2  1  0  3  3  2  2  11 2  11 2  0  2  2  2  11 2  2
0  2  11 0  11 11 2  11 11 11 11 2  3  2  0  2  3  2  8  11
3  3  2  11 0  0  11 0  0  0  11 2  11 2  11 3  11 3  3  0
19 2  2  11 11 2  2  3  0  11 11 11 11 11 2  3  3  2  3  2
3  19 3  3  4  4  4  4  4  11 11 15 11 2  2  2  2  2  2  2
19 19 2  0  4  3  3  0  4  3  11 8  11 11 11 2  2  3  3  5
2  19 19 2  4  0  13 0  4  2  11 11 11 11 3  11 3  11 2  5
3  2  3  3  4  0  0  2  4  11 2  11 11 11 11 2  11 2  2  5
2  0  3  11 4  4  4  4  4  2  2  3  11 2  3  12 5  5  5  5
19 2  3  2  2  3  12 11 11 3  11 3  2  11 2  11 11 2  2  11
2  2  2  11 3  0  3  2  11 11 3  0  3  11 11 11 11 2  11 2 
3  2  11 2  7  2  2  11 11 7  8  11 11 2  11 11 11 11 3  3 
11 2  2  11 11 2  3  2  11 2  11 11 11 11 11 11 11 11 2  3 
3  2  0  2  6  2  3  3  11 11 11 11 11 0  0  11 11 11 11 2 
3  2  3  11 15 3  2  11 11 0  11 2  0  0  0  0  0  11 11 11
2  19 3  3  0  3  3  11 11 11 2  0  3  0  2  2  0  0  11 11
2  2  2  11 2  2  3  11 11 8  11 3  3  2  2  11 2  0  0  11
3  2  11 5  5  5  6  13 11 7  2  3  2  3  0  3  15 8  0  3
2  2  2  5  2  2  2  2  3  2  2  3  2  3  2  3  2  2  3  11
3  3  2  5  19 2  11 3  3  0  2  2  0  2  11 3  2  2  2  2
playerRotation: 1
playerHasRifle: 0
playerStartAmmo: 0
mirrorRotations: 1 3 2
lancerRotations: 0 0 2
lancerCoolDowns: X
togglerStates: X
togglerCoolDowns: X
ammoSupplies: X